3
##########
!@. . ..!#
#! @@! . #
#        #
##########
