1
111111111
112222211
122   221
1222 2221
122   221
1222 2221
BREAK
2
   
  11 11
 112 221
111222111
 122221
  1222
   11
BREAK
3
   111 
  33333 
1234443 1
1 3444321
123444321
1 3 2 3 1
BREAK
4
112222211
12     21
122   221
1122 2211
222222222
111111111
BREAK
5
444444444
222222222
233   332
222222222
 2333332
444444444
BREAK